Berlin	Germany
Hamburg	Germany
München	Germany
Köln	Germany
Frankfurt	Germany
Essen	Germany
Dortmund	Germany
Stuttgart	Germany
Düsseldorf	Germany
Bremen	Germany
Hannover	Germany
Duisburg	Germany
Nürnberg	Germany
Leipzig	Germany
Dresden	Germany
Bochum	Germany
Wuppertal	Germany
Bielefeld	Germany
Bonn	Germany
Mannheim	Germany
Karlsruhe	Germany
Gelsenkirchen	Germany
Wiesbaden	Germany
Münster	Germany
Mönchengladbach	Germany
Chemnitz	Germany
Augsburg	Germany
Braunschweig	Germany
Aachen	Germany
Krefeld	Germany
Halle	Germany
Kiel	Germany
Magdeburg	Germany
Oberhausen	Germany
Lübeck	Germany
Freiburg	Germany
Hagen	Germany
Erfurt	Germany
Kassel	Germany
Rostock	Germany
Mainz	Germany
Hamm	Germany
Saarbrücken	Germany
Herne	Germany
Mülheim	Germany
Solingen	Germany
Osnabrück	Germany
Ludwigshafen	Germany
Leverkusen	Germany
Oldenburg	Germany
Neuss	Germany
Paderborn	Germany
Heidelberg	Germany
Darmstadt	Germany
Potsdam	Germany
Würzburg	Germany
Göttingen	Germany
Regensburg	Germany
Recklinghausen	Germany
Bottrop	Germany
Wolfsburg	Germany
Heilbronn	Germany
Ingolstadt	Germany
Ulm	Germany
Remscheid	Germany
Pforzheim	Germany
Bremerhaven	Germany
Offenbach	Germany
Fürth	Germany
Reutlingen	Germany
Salzgitter	Germany
Siegen	Germany
Gera	Germany
Koblenz	Germany
Moers	Germany
Bergisch Gladbach	Germany
Cottbus	Germany
Hildesheim	Germany
Witten	Germany
Zwickau	Germany
Erlangen	Germany
Iserlohn	Germany
Trier	Germany
Kaiserslautern	Germany
Jena	Germany
Schwerin	Germany
Gütersloh	Germany
Marl	Germany
Lünen	Germany
Esslingen	Germany
Velbert	Germany
Ratingen	Germany
Düren	Germany
Ludwigsburg	Germany
Wilhelmshaven	Germany
Hanau	Germany
Minden	Germany
Flensburg	Germany
Dessau	Germany
Villingen-Schwenningen	Germany
Tallinn	Estonia
Tartu	Estonia
Narva	Estonia
Pärnu	Estonia
Kohtla-Järve	Estonia
Viljandi	Estonia
Rakvere	Estonia
Maardu	Estonia
Sillamäe	Estonia
Kuressaare	Estonia
Võru	Estonia
Valga	Estonia
Haapsalu	Estonia
Jõhvi	Estonia
Paide	Estonia
Keila	Estonia
Kiviõli	Estonia
Tapa	Estonia
Põlva	Estonia
Jõgeva	Estonia
Türi	Estonia
Elva	Estonia
Rapla	Estonia
Saue	Estonia
Põltsamaa	Estonia
Paldiski	Estonia
Sindi	Estonia
Kunda	Estonia
Kärdla	Estonia
Loksa	Estonia
Tõrva	Estonia
Kehra	Estonia
Räpina	Estonia
Narva-Jõesuu	Estonia
Tamsalu	Estonia
Kilingi-Nõmme	Estonia
Otepää	Estonia
Karksi-Nuia	Estonia
Püssi	Estonia
Mustvee	Estonia
Võhma	Estonia
Lihula	Estonia
Antsla	Estonia
Abja-Paluoja	Estonia
Suure-Jaani	Estonia
Kallaste	Estonia
Mõisaküla	Estonia
Akaa	Finland
Alajärvi	Finland
Alavus	Finland
Espoo	Finland
Forssa	Finland
Haapajärvi	Finland
Haapavesi	Finland
Hamina	Finland
Hanko	Finland
Harjavalta	Finland
Haukipudas	Finland
Heinola	Finland
Helsinki	Finland
Huittinen	Finland
Hyvinkää	Finland
Hämeenlinna	Finland
Iisalmi	Finland
Ikaalinen	Finland
Imatra	Finland
Pietarsaari	Finland
Joensuu	Finland
Juankoski	Finland
Jyväskylä	Finland
Jämsä	Finland
Järvenpää	Finland
Kaarina	Finland
Kajaani	Finland
Kalajoki	Finland
Kankaanpää	Finland
Kannus	Finland
Karkkila	Finland
Kaskinen	Finland
Kauhajoki	Finland
Kauhava	Finland
Kauniainen	Finland
Kemi	Finland
Kemijärvi	Finland
Kerava	Finland
Keuruu	Finland
Kitee	Finland
Kiuruvesi	Finland
Kokemäki	Finland
Kokkola	Finland
Kotka	Finland
Kouvola	Finland
Kristiinankaupunki	Finland
Kuhmo	Finland
Kuopio	Finland
Kurikka	Finland
Kuusamo	Finland
Lahti	Finland
Laitila	Finland
Lappeenranta	Finland
Lapua	Finland
Lieksa	Finland
Lohja	Finland
Loimaa	Finland
Loviisa	Finland
Maarianhamina	Finland
Mikkeli	Finland
Mänttä-Vilppula	Finland
Naantali	Finland
Nilsiä	Finland
Nivala	Finland
Nokia	Finland
Nurmes	Finland
Uusikaarlepyy	Finland
Närpiö	Finland
Orimattila	Finland
Orivesi	Finland
Oulainen	Finland
Oulu	Finland
Outokumpu	Finland
Paimio	Finland
Parainen	Finland
Parkano	Finland
Pieksämäki	Finland
Pori	Finland
Porvoo	Finland
Pudasjärvi	Finland
Pyhäjärvi	Finland
Raahe	Finland
Raasepori	Finland
Raisio	Finla
Rauma	Finland
Riihimäki	Finland
Rovaniemi	Finland
Saarijärvi	Finland
Salo	Finland
Sastamala	Finland
Savonlinna	Finland
Seinäjoki	Finland
Siuntio	Finland
Somero	Finland
Suonenjoki	Finland
Tampere	Finland
Tornio	Finland
Turku	Finland
Ulvila	Finland
Uusikaupunki	Finland
Vaasa	Finland
Valkeakoski	Finland
Vantaa	Finland
Varkaus	Finland
Viitasaari	Finland
Virrat	Finland
Ylivieska	Finland
Ylöjärvi	Finland
Ähtäri	Finland
Äänekoski	Finland
